11111111111
10000000001
11110P00X01
10X000E0XC1
10000X00111
11111111111