1111111111111111111111111111111111
1E0000000000000C00000C000000000001
10100101001000001010010000Y0010101
1010010010101010001001000000010101
1P0000000C00C000000000X000000000C1
1111111111111111111111111111111111
