111111111111111111
1P000000X000C00C01
10000C000000C0C001
111110000000111111
1C0X0C00000000X0C1
10C0000C11C0000001
1000X0000X000C0X01
1000E000000C0000C1
111111111111111111