111111111111111111111111
101110000000000000000001
101100000000000000000001
100111111111100CC000Y001
100011111111000000E00001
10000000X0000000C0000001
1000000000000P0000000001
111111111111111111111111
