11111111
100000P1
10000001
1Y0C0001
11110X01
11111101
1E0000C1
11111111
