1111111111111111111111111111111111
1E0000000000000C00000C000000000001
1010010100100000101001000000010101
1010010010101010001001000X00010101
1P0000X00C00C00000000000000000Y0C1
1111111111111111111111111111111111
