1111111111111111111111
100000X000Y00000000001
10000000E0000P0C000001
1111111111111111111111